10 10
##########
####T##X##
#M#####X##
#######X##
####XXXX##
#X########
#X####S#C#
#XXX##F###
##########
######B###